question	question_en	answer	trickyAnswer							
Какой термин используется для обозначения совокупности элементов, с помощью которых пользователь взаимодействует с программой?	What term is used to refer to the set of elements through which the user interacts with the program?	Интерфейс (Interface)	Блок (Block)							
Какой объект позволяет сгруппировать несколько элементов вместе и управлять ими одновременно?	Which object allows you to group several elements together and manage them at the same time?	Слой (Layer)	Компонент (Component)							
Какой метод размещения элементов позволяет указать точную координату расположения на экране?	What method of placing elements allows you to specify the exact coordinate of the location on the screen?	Абсолютное позиционирование (Absolute positioning)	Выравнивание (alignment)							
Какая функция позволяет автоматически выстраивать элементы в виде колонок и рядов?	What function allows you to automatically arrange elements in the form of columns and rows?	Столбцы и строки (Columns and rows)	Текстовое поле (Text field)							
Какая концепция позволяет наследовать общие параметры от родительских элементов и применять относительное изменение размеров?	What concept allows you to inherit common settings from parent elements and apply relative sizing?	Концепция вложенности (Nesting concept)	Выравнивание (alignment)							
Какая функция позволяет автоматически подгонять размер элементов под контент или заполнять родительский элемент полностью?	What function allows you to automatically fit the size of the elements to the content or fill the parent element completely?	Автоматическое выравнивание (Auto leveling)	Иерархия (Hierarchy)							
Какой термин означает использование игровых элементов и концепций для обучения?	Which term refers to the use of game elements and concepts for learning?	Геймификация (Gamification)	Отступ (Indent)							
Как называется процесс создания и макетирования веб-сайтов?	What is the name of the process of creating and layout websites?	Веб-дизайн (Web design)	Сборка (Assembly)							
Какой термин означает настройку и изменение элементов в соответствии с индивидуальными предпочтениями?	Which term means customizing and changing elements to suit individual preferences?	Кастомизация (Customization)	Подсказка (Clue)							
Как называется все программы и данные,хранящиеся на компьютере или устройстве?	What is the name of all the programs and data stored on a computer or device?	Софт (Soft)	Шаблон (Sample)							
Что это за элемент в Framer, который можно скопировать и повторно использовать в разных частях макета?	What is this element in Framer that can be copied and reused in different parts of the layout?	Объект (An object)	Заливка (fill)							
Как называется панель в Framer, показывающая все элементы макета и их взаимосвязь?	What is the name of the panel in Framer that shows all the layout elements and their relationship?	Иерархия (Hierarchy)	Корневой элемент (Root element)							
Как называется законченный блок кода в Framer, который можно повторно использовать в разных проектах?	What is the name of a finished block of code in Framer that can be reused across projects?	Участок кода (Code section)	Макет (Layout)							
Как называется эффект движения и изменения свойств элемента на макете?	What is the name of the effect of movement and changing the properties of an element on the layout?	Анимация (Animation)	Стилизация (Stylization)							
Какой термин используется для обозначения кнопок, ползунков и других элементов	What term is used to refer to buttons, sliders, and other elements	Элементы управления (Controls)	Анимация (Animation)							
Как называется расстояние между элементами на макете?	What is the name of the distance between elements on the layout?	Отступ (Indent)	Отзывчивость (Responsiveness)							
Как называется набор цветов, используемых для создания макета?	What is the name of the set of colors used to create the layout?	Цветовая палитра (Color palette)	Цветовая палитра (Color palette)							
Как называется стиль и оформление текста на макете?	What is the name of the style and design of the text on the layout?	Типографика (Typography)	Компонент (Component)							
Какой термин используется для загрузки изображений и других файлов на макет?	What term is used to upload images and other files to a layout?	Импортирование (Importing)	Импорт (Import)							
Что это за символический макет, который демонстрирует функциональность и взаимодействие элементов на макете?	What is this symbolic layout that demonstrates the functionality and interaction of the elements on the layout?	Прототип (Prototype)	Шрифт (Font)							
Что это за функция, позволяющая пользователю изменять и взаимодействовать с элементом на макете?	What is this feature that allows the user to change and interact with an element on the layout?	Взаимодействие (Interaction)	Группировка (grouping)							
Какой термин означает адаптивность макета под различные размеры экранов и устройств?	Which term means adaptive layout to different screen sizes and devices?	Отзывчивость (Responsiveness)	Курсор (Cursor)							
Какой термин используется для готовых макетов и элементов, которые можно применить к своему проекту?	What is the term used for ready-made layouts and elements that you can apply to your project?	Шаблоны (Templates)	Прозрачность (Transparency)							
Что это за концепция, позволяющая использовать одни и те же элементы в разных частях макета?	What is the concept of allowing the same elements to be used in different parts of the layout?	Переиспользование (Reuse)	Прототип (Prototype)							
Какой параметр определяет, насколько просвечивает элемент на макете?	What parameter determines how transparent an element is on the layout?	Прозрачность (Transparency)	Интерфейс (Interface)							
Как называется фрагмент макета, содержащий один или несколько элементов?	What is the name of a layout fragment that contains one or more elements?	Блок (Block)	Слой (Layer)							
Что это за повторно используемый элемент, созданный для выполнения определенной функции на макете?	What is this reusable element created to perform a specific function on a layout?	Компонент (Component)	Абсолютное позиционирование (Absolute positioning)							
Какой термин используется для установки одинакового расстояния между элементами на макете?	What term is used to set equal spacing between elements in a layout?	Выравнивание (alignment)	Столбцы и строки (Columns and rows)							
Как называется элемент, предназначенный для ввода текста на макете?	What is the name of the element intended for entering text on the layout?	Текстовое поле (Text field)	Концепция вложенности (Nesting concept)							
Какой параметр позволяет располагать элементы на макете по определенной прямой линии?	What parameter allows you to arrange elements on the layout in a certain straight line?	Выравнивание (alignment)	Автоматическое выравнивание (Auto leveling)							
Как называется панель в Framer, отображающая порядок элементов на макете?	What is the name of the panel in Framer that displays the order of elements on the layout?	Иерархия (Hierarchy)	Геймификация (Gamification)							
Как называется пространство между текстом или элементами и границами макета?	What is the space between text or elements and layout borders called?	Отступ (Indent)	Веб-дизайн (Web design)							
Какой термин используется для объединения нескольких элементов в один, с целью улучшения производительности?	What term is used to combine multiple elements into one to improve performance?	Сборка (Assembly)	Кастомизация (Customization)							
Как называется всплывающая подсказка, содержащая информацию о функции или элементе интерфейса?	What is the name of a tooltip containing information about a function or interface element?	Подсказка (Clue)	Софт (Soft)							
Какой термин используется для готового дизайна, который можно использовать в своих проектах?	What is the term used for a finished design that you can use in your projects?	Шаблон (Sample)	Объект (An object)							
Как называется процесс заполнения элемента цветом или текстурой?	What is the process of filling an element with a color or texture called?	Заливка (fill)	Иерархия (Hierarchy)							
Какой элемент является основой иерархии элементов на макете?	Which element is the basis of the element hierarchy in the layout?	Корневой элемент (Root element)	Участок кода (Code section)							
Что обозначает схематическое изображение веб-страницы или приложения?	What does a schematic representation of a web page or application mean?	Макет (Layout)	Анимация (Animation)							
Какой термин используется для изменения внешнего вида элемента интерфейса?	What term is used to change the appearance of an interface element?	Стилизация (Stylization)	Элементы управления (Controls)							
Как называется процесс создания движения и изменения формы элементов на макете?	What is the process of creating movement and changing the shape of elements on a layout called?	Анимация (Animation)	Отступ (Indent)							
Какой термин означает адаптивность макета под различные размеры экранов?	Which term means adaptive layout to different screen sizes?	Отзывчивость (Responsiveness)	Цветовая палитра (Color palette)							
Как называется набор цветов, используемых в дизайне макета?	What is the name of the set of colors used in layout design?	Цветовая палитра (Color palette)	Типографика (Typography)							
Что означает повторно используемый элемент дизайна?	What does a reusable design element mean?	Компонент (Component)	Импортирование (Importing)							
Что указывает на загрузку изображений и других файлов на макет?	What indicates the loading of images and other files on the layout?	Импорт (Import)	Прототип (Prototype)							
Как называется набор знаков определенного стиля, используемый для отображения текста на макете?	What is the name of a character set of a certain style used to display text on a layout?	Шрифт (Font)	Взаимодействие (Interaction)							
Какой термин используется для объединения нескольких элементов в один на макете?	What term is used to combine multiple elements into one in a layout?	Группировка (grouping)	Отзывчивость (Responsiveness)							
Что показывает позицию ввода данных или текущее действие на макете?	What does the data entry position or current action show on the layout?	Курсор (Cursor)	Шаблоны (Templates)							
Какой параметр определяет степень непрозрачности элемента на макете?	What parameter determines the degree of opacity of an element on the layout?	Прозрачность (Transparency)	Переиспользование (Reuse)							
Что обозначает условный эскиз, показывающий функциональность и взаимодействие элементов на макете?	What does a conditional sketch mean, showing the functionality and interaction of elements on a layout?	Прототип (Prototype)	Прозрачность (Transparency)							
Какой язык используется для пользовательского интерфейса Framer? 	What language is used for Framer's user interface?	Английский (English)	Русский (Russian)							
Как можно точно позиционировать фреймы в Framer? 	How can frames be precisely positioned in Framer?	Абсолют (Abs)	Относительное позиционирование (Relative positioning)							
Какой концепт в Framer позволяет автоматически располагать фреймы в столбцах и строках? 	Which concept in Framer allows frames to be automatically organized in columns and rows?	Авто (Auto)	Случайное позиционирование (Random positioning)							
Что делает вложенность в Framer? 	What does nesting do in Framer?	Общие параметры (Shared parameters)	Удаляет параметры (Removes parameters)							
Каким образом в Framer можно задавать относительный размер для элементов интерфейса? 	How can you define relative sizing for UI elements in Framer?	Подгонка или заполнение (Fit or fill)	Абсолютный размер (Absolute size)							
Что означает кнопка "Открыть" в графическом редакторе? 	What does the "Open" button signify in a graphic editor?	Открыть (Open)	Позволяет сохранить файл (Allows you to save a file)							
Что обозначает иконка "Удалить" в интерфейсе Framer? 	What does the "Delete" icon represent in the Framer interface?	Удалить (Delete)	Копирует элемент (Duplicates the element)							
Как называется панель, где можно выбрать цвет в графическом редакторе? 	What is the name of the panel where you can select color in a graphic editor?	Цвет (Color)	Инструменты (Tools)							
Какой инструмент используется для рисования прямых линий в графическом редакторе? 	Which tool is used to draw straight lines in a graphic editor?	Линия (Line)	Кисть (Brush)							
Какой элемент интерфейса обычно используется для изменения размера объекта? 	Which UI element is commonly used to resize an object?	Ручка (Handle)	Кнопка "Сохранить" (Save button)							
Что означает кнопка "Открыть" в графическом редакторе?	What does the "Open" button mean in the graphics editor?	Открыть (Open)	Позволяет сохранить файл							
Что обозначает иконка "Удалить" в интерфейсе Framer?	What does the "Delete" icon mean in the Framer interface?	Удалить (Delete)	Копирует элемент							
Как называется панель, где можно выбрать цвет в графическом редакторе?	What is the name of the panel where you can select a color in a graphical editor? (What is the name of the panel where you can select color in a graphic editor?)	Цвет (Color)	Инструменты							
Какой инструмент используется для рисования прямых линий в графическом редакторе?	What tool is used to draw straight lines in a graphics editor?	Линия (Line)	Кисть							
Какой элемент интерфейса обычно используется для изменения размера объекта?	What interface element is commonly used to resize an object?	Ручка (Pen)	Кнопка "Сохранить"							
Что является "лучшим другом" дизайнера в UI проекте?	What is a designer's "best friend" in a UI project?	Грид (Grid)	Гайдлайны (Guidelines)							
Какой инструмент стоит взять с собой в путешествие по UI просторам?	What tool should you take with you on your UI journey?	Пиксель (Pixel)	Утка-пробник (Rubber Duck)							
Как называется секретный клуб, в котором собираются все UI дизайнеры?	What is the name of the secret club where all UI designers gather?	Pixel'ное Братство (Pixel Brotherhood)	Кодермэн (Coded Crusader)							
Как зовут волшебный инструмент, превращающий wireframe в полноценный дизайн?	What is the name of the magical tool that turns a wireframe into a full-fledged design?	Магия (Magic)	Жизнь (Life)							
В мире UI какое место занимает типография?	What is the role of typography in the world of UI?	Король (King)	Магическая палочка (Magic Wand)							
Каким суперсилам обладает легендарный "UIладелец"?	What superpowers does the legendary "UI owner" have?	Интерактивность (Interactivity)	Ящик с пикселями (Pixel Box)							
Какое заклинание нужно произнести для создания идеального цветового сочетания?	What spell needs to be cast to create the perfect color combination?	Сила цветов (Color Magic)	T-пикселька (Pixel Tee)							
Какую личину принимает UI дизайнер в светлую лунную ночь?	What disguise does a UI designer take on a bright moonlit night?	Дизайнер-елец (Design-Owl)	Круг (Circle)							
Что служит наставником в UI царстве?	What serves as a mentor in the UI realm?	Гайдлайны (Guidelines)	Пиксельная Фея (Pixel Fairy)							
Какой объект является источником вдохновения для творческих UI дизайнеров?	What object is a source of inspiration for creative UI designers?	Утка-пробник (Rubber Duck)	Пиксели (Pixels)							
Какой супергерой защищает UI от злых багов?	Which superhero protects the UI from evil bugs?	Кодермэн (Coded Crusader)	Любви (Love)							
Что происходит, когда UI элемент делает свою первую анимацию?	What happens when a UI element makes its first animation?	Жизнь (Life)	Пиксель (Pixel)							
Какой инструмент поможет уменьшить количество кликов при создании UI?	What tool will help reduce the number of clicks when creating a UI?	Магическая палочка (Magic Wand)	Грид (Grid)							
Какой объект используют UI дизайнеры для временного хранения идей?	What object do UI designers use to temporarily store ideas?	Ящик с пикселями (Pixel Box)	Пиксель (Pixel)							
Какой стиль одежды самый популярный у UI дизайнеров?	What is the most popular clothing style for UI designers?	T-пикселька (Pixel Tee)	Pixel'ное Братство (Pixel Brotherhood)							
Какой символ является логотипом UI дизайнера?	What symbol is a UI designer's logo?	Круг (Circle)	Магия (Magic)							
Какой сказочный персонаж дарует UI дизайнерам ночные маршруты?	Which fairy-tale character bestows night routes on UI designers?	Пиксельная Фея (Pixel Fairy)	Король (King)							
Какое сокровище ищут все UI исследователи?	What treasure are all UI researchers searching for?	Пиксели (Pixels)	Интерактивность (Interactivity)							
Чего желает UI дизайнер от программистов?	What does a UI designer want from programmers?	Любви (Love)	Сила цветов (Color Magic)							
Что изображено на фирменной футболке UI дизайнера?	What is shown on a UI designer's branded T-shirt?	Пиксель (Pixel)	Дизайнер-елец (Design-Owl)							
Что должен сделать UI дизайнер, чтобы стать незаменимым?	What should a UI designer do to become indispensable?	Удивить (Amaze)	Вебсайт (Website)							
Какой инструмент используется для создания магических эффектов в UI?	What tool is used to create magical effects in the UI?	Волшебство (Magic)	Предложить показы PowerPoint (Suggest PowerPoint presentations)							
Как называется учебное заведение, где учат UI дизайну?	What is the name of the school that teaches UI design?	Школа (School)	Фотошоп (Photoshop)							
Какого животного боятся плохие UI элементы?	What animal are bad UI elements afraid of?	Слоны (Elephants)	Университет (University)							
Что делает UI дизайнер, чтобы привнести живость в интерфейс?	What does a UI designer do to bring life to an interface?	Анимации (Animations)	Пингвины (Penguins)							
Как называется протокол связи между UI и программистами?	What is the name of the communication protocol between UI and programmers?	Сотрудничество (Collaboration)	Магия (Magic)							
Какой объект часто используют UI дизайнеры для демонстрации динамичных прототипов?	What object is often used by UI designers to demonstrate dynamic prototypes?	Телефон (Phone)	Территориальный спор (Territorial dispute)							
Что означает зеленая кнопка в UI дизайне?	What does the green button mean in UI design?	Перейти (Go)	Карусель (Carousel)							
Что говорит UI элемент, когда застревает в процессе анимации?	What does a UI element say when it gets stuck in the animation process?	Помощь (Help)	Закрыть (Close)							
Что делают UI дизайнеры, чтобы сохранить вдохновение?	What do UI designers do to keep inspired?	Путешествуют (Travel)	Ой (Oops)							
Какой стиль интерфейса пользуется большой популярностью среди UI дизайнеров?	What interface style is most popular among UI designers?	Минимализм (Minimalism)	Медитация (Meditation)							
Что происходит, когда UI дизайнер вносит неожиданные изменения в проект?	What happens when a UI designer makes unexpected changes to a project?	Сюрприз (Surprise)	Ретро (Retro)							
Какая фраза никогда не говорится UI дизайнеру?	What phrase is never said to a UI designer?	Мне нравится все (I like everything)	Паника (Panic)							
Какой инструмент используется для измерения точности UI элементов?	What tool is used to measure the accuracy of UI elements?	Линейка (Ruler)	Может ли страница иметь 10 цветов одновременно? (Can a page have 10 colors at once?)							
Как происходит "связь душ" между UI дизайнером и программистом?	How does the "connection of souls" between UI designer and programmer take place?	Коммуникация (Communication)	Пробка от ручки (Pen cap)							
Что считается манной небесной для UI дизайнера?	What is considered manna from heaven for a UI designer?	Комплимент (Compliment)	Невидимая нить (Invisible thread)							
Какая программа требуется для управления UI дизайнером?	What program is required to manage the UI designer?	Фантазия (Imagination)	Новая роль в фильме (New role in a movie)							
Чем увлекается UI дизайнер во время перерыва?	What does a UI designer do during a break?	Перекур (Smoke)	Рэп (Rap)							
Что является главным источником пищи для UI дизайнера?	What is the main food source for a UI designer?	Гибкие макеты (Flexbox)	Сборкой головоломок (Solving puzzles)							
Как называется область на экране, где вы можете создавать и редактировать свой веб-сайт?	What is the name of the area on the screen where you can create and edit your website?	Канваc (Canvas)	Монтажная область (Artboard)							
Что такое абсолютное позиционирование?	What is absolute positioning?	Абсолютное (Absolute positioning)	Статическое позиционирование (Static positioning)							
Как называется процесс размещения элемента внутри другого элемента?	What is the process of placing an element inside another element called?	Вложение (Nesting)	Укладка (Stacking)							
Что такое дочерний элемент?	What is a child element?	Дочерний элемент (Child element)	Родительский элемент (Parent element)			Фламинго	кофе-машина	рояль (Flamingo	coffee machine	piano)
Какой термин описывает автоматическое позиционирование элементов в колонки и строки?	Which term describes the automatic positioning of elements in columns and rows?	Автопозиционирование (Auto positioning)	Флексбокс (Flexbox)							
Чему служит функция "fitContent()" в Framer?	What is the purpose of the "fitContent()" function in Framer?	Auto height (To size the element based on its content)	Чтобы центрировать элемент (To center the element)							
Какой термин описывает заполнение родительского элемента всем доступным пространством?	Which term describes filling the parent element with all available space?	Заполнить (Fill parent)	Flex-расти (Flex-grow)							
Как называется пропорциональное изменение размера элемента соответственно изменению размера родительского элемента?	What is called proportional resizing of an element according to the resizing of the parent element?	Относительный размер (Relative sizing)	Фиксированный размер (Fixed sizing)							
Что такое пользовательский интерфейс (user interface)?	What is a user interface?	UI (Interface that allows users to interact with a system)	Интерфейс, которым сложно пользоваться (Interface that is hard to use)			Кусачки	молоток	нитки (Scissors	hammer	thread)
Какой термин описывает распространение общих параметров от родителя к дочерним элементам?	Which term describes the propagation of shared parameters from parent to child elements?	Распространение (Propagating)	Клонирование (Cloning)							
Как называется панель	What is the name of the panel	Toolbar (на которой располагаются инструменты для редактирования элементов в Framer?)	Панель (Панель)			паучьи лапки (Hieroglyphs	pixels	spider's paws)		
Что такое курсор в графическом редакторе?	What is a cursor in a graphics editor?	Курсор (Cursor)	Указатель (Pointer)							
Как называется способ изменения размера элемента путем изменения его ширины или высоты?	What is the name of the way to resize an element by changing its width or height?	Размер (Resizing)	Масштабирование (Scaling)							
Что такое группировка (grouping) элементов в Framer?	What is grouping of elements in Framer?	Группировка (Combining multiple elements into a single entity)	Выравнивание элементов (Aligning elements)							
Как называется инструмент для выделения и вырезания части изображения?	What is the name of the tool for selecting and cutting out a part of an image?	Обрезка (Crop tool)	Инструмент выделения (Selection tool)							
Что такое макет (layout) в веб-дизайне?	What is a layout in web design?	Макет (Arrangement of elements on a webpage)	Цветовая схема (Color scheme)							
Как называется изменение цвета элемента, если указатель мыши находится над ним?	What is the name for changing the color of an element when the mouse pointer is over it?	Ховер (Hover effect)	Эффект фокусировки (Focus effect)							
Что такое шрифт (font) в графическом дизайне?	What is a font in graphic design?	Шрифт (Style of letters and characters)	Типография (Typography)							
Как называется инструмент для рисования прямоугольника или круга?	What is the name of the tool for drawing a rectangle or circle?	Инструмент (Shape tool)	Кисть (Paintbrush)			Звезды	планеты	кометы (Stars	planets	comets)
Что такое рамка (border) элемента в веб-дизайне?	What is a border element in web design?	Рамка (Outline around the element)	Тень (Shadow)							
Как называется расстояние между элементами на веб-странице?	What is the spacing between elements on a web page called?	Промежуток (Spacing)	Допуск (Margin)							
Что такое фон (background) элемента в веб-дизайне?	What is the background of an element in web design?	Фон (The visual layer behind the content)	Передний план (Foreground)							
Как называется набор предопределенных стилей для элементов в Framer?	What is the name of the set of predefined styles for elements in Framer?	Шаблон (Template)	Макет (Layout)							
Что такое выравнивание элементов в Framer?	What is element alignment in Framer?	Выравнивание (Positioning elements in relation to each other)	Вращение (Rotation)							
Как называется выбор цвета из палитры в графическом редакторе?	What is the name of choosing a color from a palette in a graphical editor?	Палитра (Color picker)	Инструмент заливки (Fill tool)							
Что такое тень (shadow) элемента в веб-дизайне?	What is an element's shadow in web design?	Тень (A visual effect indicating depth or elevation)	Эффект размытия (Blur effect)							
Как называется функция плавного изменения значений свойств элемента?	What is the name of the function of smoothly changing the values of the properties of an element?	Анимация (Transition)	Трансформировать (Transform)							
Что такое прозрачность (opacity) элемента в веб-дизайне?	What is element transparency in web design?	Прозрачность (Degree of transparency)	Видимость (Visibility)							
Как называется способ поворота элемента в Framer?	What is the name of the way to rotate an element in a Framer?	Поворот (Rotation)	Масштабирование (Scaling)							
Что такое границы (margins) элемента в веб-дизайне?	What are element margins in web design?	Границы (Space between the element and its surroundings)	Прокладка (Padding)							
Как называется способ выделения нескольких элементов одновременно?	What is the name of the way to select several elements at the same time?	Мультивыделение (Multiple selection)	Одиночный выбор (Single selection)							
Что такое выступление (outline) элемента в веб-дизайне?	What is an element's outline in web design?	Выступление (Visible border around the element)	Тень (Drop shadow)							
Как называется процесс вставки изображения в Framer?	What is the name of the process of inserting an image into Framer?	Вставка изображения (Image insertion)	Загрузка изображения (Image upload)							
Что такое отступы (padding) элемента в веб-дизайне?	What is padding on an element in web design?	Отступ (Space between the element's content and its border)	Допуск (Margin)							
Как называется инструмент для выбора цвета в графическом редакторе?	What is the name of the color selection tool in the graphics editor?	Пипетка (Eyedropper tool)	Зубная щетка (Brush tool)							
Что такое ширина (width) элемента в веб-дизайне?	What is the width of an element in web design?	Ширина (Horizontal measurement of the element)	Высота (Height)							
Как называется стиль, применяемый к элементу при нажатии?	What is the name of the style applied to an element when clicked?	Активное состояние (Active state)	Состояние наведения (Hover state)							
Что такое контрастность (contrast) в графическом дизайне?	What is contrast in graphic design?	Контрастность (Difference between light and dark areas)	Эффект размытия (Blur effect)							
Как называется набор предопределенных цветовых схем в Framer?	What is the name of the set of predefined color schemes in Framer?	Палитра (Color palette)	Градиент (Gradient)							
Что такое выравнивание по центру (center alignment) элемента в Framer?	What is the center alignment of an element in a Framer?	Выравнивание по центру (Aligning the element to the center)	Обоснуйте выравнивание (Justify alignment)							
Как называется инструмент для рисования свободной кривой?	What is the name of the free curve drawing tool?	Перо (Pen tool)	Инструмент заливки (Fill tool)							
Что такое масштабирование (scaling) элемента в веб-дизайне?	What is element scaling in web design?	Масштабирование (Changing the size of the element proportionally)	Вращение (Rotation)							
Как называется функция для повторного использования стилей в Framer?	What is the name of the function for reusing styles in Framer?	Компонент (Component)	Сорт (Class)							
Что такое прозрачный фон (transparent background) в графическом дизайне?	What is a transparent background in graphic design?	Прозрачный фон (Background with no visible color or pattern)	Фон изображения (Image background)							
Как называется сетка (grid) в веб-дизайне?	What is a grid called in web design?	Сетка (A system of horizontal and vertical lines)	Маскировка (Masking)							
Что такое CSS в веб-дизайне?	What is CSS in web design?	СSS (Cascading Style Sheets)	HTML (HTML)							
Как называется инструмент для рисования линии?	What is the name of the line drawing tool?	Линия (Line tool)	Карандаш (Pencil tool)							
Что такое библиотека (library) в Framer?	What is a library in Framer?	Библиотека (A collection of reusable design elements)	Панель настроек (Settings panel)							
Как называется функция для изменения порядка слоев элементов?	What is the name of the function to change the order of layers of elements?	Слои (Layering)	Группировка (Grouping)							
Что такое пиксель (pixel) в графическом дизайне?	What is a pixel in graphic design?	Пиксель (Smallest unit of a digital image)	Вектор (Vector)							
Как называется процесс изменения прозрачности элемента в Framer?	What is the process of changing the transparency of an element in Framer called?	Прозрачность (Opacity)	Видимость (Visibility)							
Что такое градиент (gradient) в графическом дизайне?	What is a gradient in graphic design?	Градиент (Smooth transition between colors)	Шаблон (Pattern)							
Как называется инструмент для рисования эллипса или окружности?	What is the name of the tool for drawing an ellipse or circle?	Эллипс (Ellipse tool)	Инструмент «Прямоугольник» (Rectangle tool)							
Что такое адаптивный дизайн (adaptive design) в веб-дизайне?	What is adaptive design in web design?	Адаптивный дизайн (Design that adjusts to different screen sizes)	Фиксированная раскладка (Fixed layout)							
Как называется способ редактирования текстового содержимого элемента в Framer?	What is the name of the way to edit the text content of an element in a Framer?	Редактирование текста (Text editing)	Форматирование текста (Text formatting)							
Что такое выравнивание по вертикали (vertical alignment) элемента в Framer?	What is the vertical alignment of an element in a Framer?	Выравнивание по вертикали (Aligning the element vertically)	Выравнивание элемента по левому краю (Aligning the element to the left)							
Как называется кнопка для отмены последнего действия в графическом редакторе?	What is the name of the button to undo the last action in the graphical editor?	Отменить (Undo button)	Кнопка «Повторить» (Redo button)							
Что такое границы (borders) в графическом дизайне?	What are borders in graphic design?	Границы (Lines around the edge of an element)	Фильтры (Filters)							
Как называется инструмент для выделения области изображения?	What is the name of the selection tool?	Выделение (Marquee tool)	Ластик (Eraser tool)							
Что такое применение стилей (applying styles) к элементам в Framer?	What is applying styles to elements in Framer?	Применение стилей (Setting visual properties of elements)	Составляющие элементы (Composing elements)							
Как называется инструмент для рисования полигона или ломаной?	What is the name of the tool for drawing a polygon or polyline?	Полигон (Polygon tool)	Инструмент заливки (Fill tool)							
Что такое дистанцирование (spacing) элементов в веб-дизайне?	What is element spacing in web design?	Дистанцирование (Arrangement of space between elements)	Маскировка (Masking)							
Как называется способ изменения цвета заливки элемента в Framer?	What is the name of the way to change the fill color of an element in Framer?	Заливка (Fill color)	Цвет обводки (Stroke color)							
Что такое репозиторий (repository) в Framer?	What is a repository in Framer?	Репозиторий (Storage for project files and version control)	Библиотека компонентов (Component library)							
Как называется инструмент для выделения области с перетаскиванием?	What is the drag and drop selection tool called?	Выделение (Lasso tool)	Инструмент для обрезки (Crop tool)							
Что такое заголовок (heading) в веб-дизайне?	What is a heading in web design?	Заголовок (Text element that indicates the topic or section)	Параграф (Paragraph)							
Как называется функция позволяющая анимировать элементы в Framer?	What is the name of the function that allows you to animate elements in Framer?	Анимация (Animation)	Переход (Transition)							
Что такое приманка (placeholder) в графическом дизайне?	What is a placeholder in graphic design?	Затычка (Temporary text or image placeholder)	Реальный контент (Real content)							
Как называется способ изменения масштаба элемента в Framer?	What is the name of the way to change the scale of an element in a Framer?	Масштабирование (Zooming)	Вращение (Rotation)							
Что такое холст (canvas) в графическом дизайне?	What is canvas in graphic design?	Холст (Area where you create and edit a design)	Рабочая среда (Workspace)							
Что такое интерактивность (interactivity) в веб-дизайне?	What is interactivity in web design?	Интерактивность (Ability for users to interact with elements)	Статический макет (Static layout)							
Как называется функция для создания анимации пути движения элемента в Framer?	What is the name of the function to animate the motion path of an element in a Framer?	Анимация пути (Path animation)	Анимация затухания (Fade animation)							
Что такое медиа-запрос (media query) в адаптивном дизайне?	What is a media query in responsive design?	Медиа-запрос (Condition for applying specific styles based on device characteristics)	Эффект перехода (Transition effect)							
Как называется процесс изменения позиции элемента во времени в Framer?	What is the name of the process of changing the position of an element in time in a Framer?	Ключевые кадры (Animation keyframes)	Обновление макета (Layout update)							
Что такое полупрозрачность (translucency) в графическом дизайне?	What is translucency in graphic design?	Полупрозрачность (Partial transparency)	Выцветший эффект (Faded effect)							
Как называется инструмент для изменения формы элемента в графическом редакторе?	What is the name of the tool for changing the shape of an element in a graphical editor?	Перо (Pen tool)	Инструмент для обрезки (Crop tool)							
Что такое функция ease-in-out в анимации в Framer?	What is ease-in-out function in framer animation?	Ease-in-out (Smooth acceleration and deceleration)	Линейная скорость (Linear speed)							
Как называется техника веб-дизайна	What is the web design technique called?	Визуальная иерархия (Visual hierarchy)	Фоновый фокус (Background focus)							
Что такое векторная графика (vector graphics) в графическом дизайне?	What is vector graphics in graphic design?	Векторная графика (Graphics created using mathematical equations)	Растровая графика (Raster graphics)							
Как называется способ вычисления и установки значения свойства элемента в Framer?	What is the name of the way to calculate and set the value of an element property in a Framer?	Вычисление значения (Variable calculation and assignment)	Статическое назначение (Static assignment)							
Что такое отражение (reflection) элемента в веб-дизайне?	What is element reflection in web design?	Отражение (Mirror-like effect below the element)	Эффект размытия (Blur effect)							
Как называется уровень прозрачностиб который позволяет увидеть содержимое нижележащего элемента?	What is the transparency level called, which allows you to see the content of the underlying element?	Прозрачность (Opacity)	Видимость (Visibility)							
Что называется спрайт (Sprite) в графическом дизайне?	What is a sprite in graphic design?	Спрайт (A single graphic that contains multiple images or frames)	Икона (Icon)							
Как называется техника плавного перехода цвета от одного к другому?	What is the name of the technique of smooth transition of color from one to another?	Градиент (Gradient)	Смешивать (Blend)							
Что такое сглаживание (anti-aliasing) в графическом дизайне?	What is anti-aliasing in graphic design?	Сглаживание (Technique to smooth jagged edges)	Заточка (Sharpening)							
Как называется команда для повторения последнего действия в графическом редакторе?	What is the name of the command to repeat the last action in the graphical editor?	Повторить (Redo)	Отменить (Undo)							
Что такое оверлей (overlay) в веб-дизайне?	What is an overlay in web design?	Оверлей (Additional layer on top of the content)	Фон (Background)							
Как называется способ управления порядком отображения элементов в Framer?	What is the name of the way to control the display order of elements in a Framer?	Z-индекс (Z-indexing)	Порядок укладки (Stacking order)							
Что такое качество (resolution) изображения в графическом дизайне?	What is image quality (resolution) in graphic design?	Качество (Clarity and level of detail)	Формат изображения (Image format)							
Как называется способ масштабирования элементов в Framer?	What is the name of the way to scale elements in Framer?	Масштабирование (Scaling)	Вращение (Rotation)							
Как называется функция для создания 3D-эффектов в Framer?	What is the name of the function for creating 3D effects in Framer?	Перспектива (Perspective)	Увеличить (Zoom)							
Что такое значок (icon) в графическом дизайне?	What is an icon in graphic design?	Значок (Simplified graphical representation of an object)	Логотип (Logo)							
Как называется способ анимации появления и исчезновения элемента?	What is the name of the way to animate the appearance and disappearance of an element?	Затухание (Fade animation)	Повернуть анимацию (Rotate animation)							
Что такое типографика (typography) в веб-дизайне?	What is typography in web design?	Типографика (Arranging and styling of text)	Дизайн макета (Layout design)							
Как называется функция для создания эффекта параллакса в Framer?	What is the name of the function to create the parallax effect in Framer?	Параллакс (Parallax scrolling)	Липкая прокрутка (Sticky scrolling)							
Что такое оптическое выравнивание (optical alignment) в графическом дизайне?	What is optical alignment in graphic design?	Оптическое выравнивание (Adjusting spacing to improve visual balance)	Выравнивание сетки (Grid alignment)							
Как называется механизм прокрутки содержимого в рамках заданного пространства?	What is the name of the mechanism for scrolling content within a given space?	Прокрутка (Scrolling)	исчезновение (Fading)							
Что такое шаг (step) анимации в Framer?	What is an animation step in Framer?	Шаг (Individual keyframe in an animation)	Задерживать (Delay)							
Как называется способ размещения элементов в виде ленты или сетки?	What is the name of the method of placing elements in the form of a ribbon or grid?	Сетка (Grid layout)	Случайное размещение (Random placement)							
Что такое сжатие (compression) изображения в графическом дизайне?	What is image compression in graphic design?	Сжатие (Reducing file size while preserving quality)	Эффект фильтра (Filter effect)							
Как называется инструмент для создания текстовых блоков в разных направлениях?	What is the name of the tool for creating text blocks in different directions?	Текст (Text tool)	Инструмент поворота (Rotate tool)							
Что такое антиприостановка (autoplay) в веб-дизайне?	What is anti-pause (autoplay) in web design?	Антиприостановка (Automatic playing of media without user interaction)	Непрерывный цикл (Continuous loop)							
Как называется метод изменения внешнего вида элемента при наведении курсора?	What is the method of changing the appearance of an element on hover called?	Ховер (Hover effect)	Псевдокласс (Pseudo class)							
Что такое респонсивный дизайн (responsive design) в веб-дизайне?	What is responsive design in web design?	Респонсивный дизайн (Design that adapts to different screen sizes and devices)	Фиксированная раскладка (Fixed layout)							
Как называется функция для определенияб будет ли элемент отображаться на экране?	What is the name of the function to determine if an element will be displayed on the screen?	Отображение (Visibility)	Отображать (Display)							
Что такое множественное выделение (multiple selection) в графическом дизайне?	What is multiple selection in graphic design?	Множественное выделение (Selecting multiple elements at once)	Одиночный выбор (Single selection)							
Как называется способ анимирования элементов с помощью физических законов?	What is the name of the way to animate elements using physical laws?	Анимация по физике (Physics-based animation)	Случайная анимация (Random animation)							
Что такое палитра (palette) в графическом дизайне?	What is a palette in graphic design?	Палитра (Collection of available colors)	Цветовое колесо (Color wheel)							
Как называется функция для добавления теней на элементы в Framer?	What is the name of the function to add shadows to elements in Framer?	Тень (Shadow)	Светиться (Glow)							
Как называется способ замены неправильного кода на правильный?	What is the name of the way to replace the wrong code with the correct one?	Отладка (Debugging)	Секретный соус (Secret sauce)							
Что такое "магическая пыль" (magic dust) в программировании?	What is "magic dust" in programming?	Магическая пыль (Mythical substance to fix bugs)	Специальный фрагмент кода (Special code snippet)							
Как называется способ найти ошибку в программеб просто глядя на нее?	What is the name of a way to find an error in a program just by looking at it?	Дебаггинг с резиновой уточкой (Rubber duck debugging)	Зная все это (Knowing it all)							
Что такое "кот на клавиатуре" (cat on the keyboard) в программировании?	What is "cat on the keyboard" in programming?	Кот на клавиатуре (Random characters generated by a cat sitting on a keyboard)	Скрытая функция (Hidden feature)							
Как называется фигурка-талisman для удачи у программистов?	What is the name of the talisman figurine for good luck for programmers?	Программистский гном (Coding gnome)	Программирующий единорог (Programming unicorn)							
Что такое "скатерть самобранка" (tablecloth teleportation) в программировании?	What is "tablecloth teleportation" in programming?	Скатерть самобранка (Belief that rearranging code magically fixes bugs)	Инструмент форматирования кода (Code formatting tool)							
Как называется способ дать понятьб что что-то не работаетб когда решение очевидно?	What is the name of the way to make it clear that something is not working when the solution is obvious?	Дебаггинг с резиновой курицей (Rubber chicken debugging)	Обвинение компьютера (Blaming the computer)							
Что такое "прокрастинация" (procrastination) в программировании?	What is "procrastination" in programming?	Прокрастинация (Putting off tasks by reading coding memes)	Супер продуктивное время (Super productive time)							
Как называется проверка кода без использования компьютера?	What is the name of checking the code without using a computer?	Проверка глазами (Eyeballing)	Волшебная прокрутка (Magic scrolling)							
Что такое "это не багб это фича" (it's not a bug, it's a feature) в программировании?	What is "it's not a bug, it's a feature" in programming?	Это не баг (Excuse for unexpected behavior)	это фича (это фича)							
Что такое "ползучий код" (spaghetti code) в программировании?	What is "creeping code" (spaghetti code) in programming?	Ползучий код (Unorganized and hard-to-follow code)	Вкусный рецепт пасты (Delicious pasta recipe)							
Как называется термин для коварного,трудноотлаживаемого кода?	What is the term for insidious, hard-to-debug code?	Хайзенбаг (Heisenbug)	Скрытый код (Stealth code)							
Что такое "код, который работал вчера, но не работает сегодня" (code that worked yesterday but doesn't today) в программировании?	What is "code that worked yesterday but doesn't today" in programming?	Закон Мерфи кодинга (Murphy's Law of Coding)	Квантовый код (Quantum code)							
Как называется способ обработки ошибок путем "просто перезагрузки"?	What's the name of the way to handle errors by "just reloading"?	Терапия перезагрузкой (Reboot therapy)	Предотвращение ошибок (Error avoidance)							
Что такое "бумажная работа" (paperwork) в программировании?	What is "paperwork" in programming?	Бумажная работа (Administrative tasks taking away coding time)	Отладка оригами (Origami debugging)							
Как называется процесс придумывания данных для тестирования?	What is the process of inventing data for testing called?	Импровизация данных (Data improvisation)	Создание вещей (Making stuff up)							
Что такое "работает на моей машине" (works on my machine) в программировании?	What is "works on my machine" in programming?	Работает на моей машине (Excuse for code that fails in other environments)	Универсальный код (Universal code)							
Как называется пустой блок кода, который нужно заполнить?	What is the name of the empty block of code that needs to be filled in?	Мороженое to-do (To-do ice cream cone)	Пустой кекс (Empty cupcake)							
Как называется состояние, когда ты изо всех сил пытаешься выровнять элементы по пикселю?	What's the name of the state when you're struggling to pixel-align elements?	Пиксель-перфекшн (Pixel-perfection)	Пиксельный хаос (Pixel chaos)							
Что происходит, когда в фреймворк добавляется слишком много фреймов?	What happens when too many frames are added to a framework?	Переполнение фреймов (Frame overflow)	Взрыв кадра (Frame explosion)							
Как называется плохо спроектированный интерфейс, который выглядит, который выглядит, как сделанный в Paint?	What is the name of a poorly designed interface that looks, that looks like it was made in Paint?	Дизайн-шедевр Paint'а (Paint-inspired design)	MS Paint специальный (MS Paint special)							
Что происходит, когда разработчик забывает закрыть все скобки в коде?	What happens when a developer forgets to close all parentheses in code?	Маньяк с фигурными скобками (Bracket mania)	Катастрофа с открытой скобкой (Open bracket disaster)							
Как называется универсальный термин, используемый вместо реального контента в макетах?	What is the name of the generic term used instead of real content in layouts?	Плейсхолдер (Placeholder)	Поддельный текст наполнителя (Fake filler text)							
Что происходит, когда цветовая схема в интерфейсе внезапно меняется на рандомные цвета?	What happens when the color scheme in the interface suddenly changes to random colors?	Цветовой апокалипсис (Color meltdown)	Цветной взрыв (Color explosion)							
Как называется процесс создания интерфейса, когда все элементы перемешиваются в хаотичном порядке?	What is the name of the process of creating an interface, when all the elements are mixed in a chaotic manner?	Замешательство интерфейса (Interface mix-up)	Беспорядок элементов (Element jumble)							
Что происходит, когда разработчик случайно удаляет весь свой код?	What happens when a developer accidentally deletes all of their code?	Исчезновение кода (Code vanishing act)	Код Гудини (Code Houdini)							
Как называется состояние, когда текст на кнопке такого маленького размера, что его невозможно прочитать?	What is the condition called when the text on a button is so small that it cannot be read?	Микроскопический текст (Microscopic label)	Путаница с элементами (Element confusion)							
Что происходит, когда элементы на макете начинают перекрывать друг друга?	What happens when elements in a layout start to overlap each other?	Хаос z-index'ов (Z-index chaos)	Тайная кнопка (Mystery button)							
Как называется процесс добавления слишком многих анимаций на страницу?	What is the process of adding too many animations to a page called?	Загрузка анимаций (Animation overload)	Анимация безумие (Animation frenzy)							
Что происходит, когда кнопка перестает реагировать на клики?	What happens when a button stops responding to clicks?	Восстание кнопок (Button rebellion)	Исчезновение магического клика (Magic click disappearance)							
Как называется состояние, когда цвета интерфейса настолько яркие	What is the name of the state when the colors of the interface are so bright	Ослепительный интерфейс (Blinding design)	Красочный кошмар (Colorful nightmare)							
Что происходит, когда элементы интерфейса случайным образом теряют свои границы?	What happens when UI elements randomly lose their borders?	Загадка без границ (Borderless confusion)	Невидимые элементы (Invisible elements)							
Как называется процесс зацикливания анимации, чтобы она никогда не заканчивалась?	What is the name of the process of looping an animation so that it never ends?	Бесконечная анимация (Animation infinity)	Циклическая иллюзия (Looping illusion)							
Что происходит, когда текст на экране слишком маленький	What happens when the text on the screen is too small	Микроскопический шрифт (Tiny font nightmare)	Волшебный сжимающийся текст (Magical shrinking text)							
Как называется положение элемента, когда он плавает где-то посередине экрана?	What is the position of an element called when it floats somewhere in the middle of the screen?	Плавающая аномалия (Floating matter)	Дрейф элемента (Element drift)							
Что происходит, когда все элементы в интерфейсе начинают пульсировать?	What happens when all the elements in the interface start to pulsate?	Пульсирующий интерфейс (Element heartbeat)	Восторженный режим пользовательского интерфейса (Rave UI mode)							
Как называется состояние, когда разработчик случайно меняет цвет кнопки вместо фона?	What is the name of the state when the developer accidentally changes the color of the button instead of the background?	Путаница цветов (Color confusion)	Фоновое переключение (Background switcheroo)							
Что происходит, когда макет отображается с двойной горизонтальной прокруткой?	What happens when the layout is displayed with double horizontal scroll?	Кошмар двойной прокрутки (Double scroll nightmare)	Прокрутка (Scrollception)							
Как называется состояние, когда бот начинает отвечать на все вопросы шуточками?	What is the name of the state when the bot starts answering all the questions with jokes?	Синдром шутливого бота (Jokester bot syndrome)	Серьезная неисправность (Serious malfunction)							
Что происходит, когда бот начинает петь песни вместо предоставления полезной информации?	What happens when the bot starts singing songs instead of providing useful information?	Музыкальная ботаника (Singing bot malfunction)	Соната перегрузка (Sonata overload)							
Как называется состояние, когда бот начинает писать код на своем собственном языке?	What is the state when a bot starts coding in its own language called?	Программирование по-ботски (Bot coding frenzy)	Кодовая тарабарщина (Code gibberish)							
Что происходит, когда бот случайно удаляет все введенные команды?	What happens when a bot accidentally deletes all entered commands?	Удаление команды (Command deletion mishap)	Удаление данных (Data wipeout)							
Как называется процесс, когда бот начинает проявлять эмоции и настроения?	What is the name of the process when the bot starts to show emotions and moods?	Эмоциональное восстание (Emotional bot uprising)	Роботизированные перепады настроения (Robotic mood swings)							
Что происходит, когда бот становится чрезмерно любопытным и начинает задавать вопросы сам себе?	What happens when a bot gets overly curious and starts asking itself questions?	Перегрузка ботовопросами (Bot curiosity overload)	вопрос (Questionception)							
Как называется состояние, когда бот начинает генерировать шутки, которые никто не понимает?	What is the name of the state when the bot starts generating jokes that no one understands?	Непонятные шутки (Incomprehensible joke syndrome)	Смех путаница (Laughter confusion)							
Что происходит, когда бот начинает повторять одну и ту же фразу в бесконечном цикле?	What happens when the bot starts repeating the same phrase in an endless loop?	Эхо бота (Bot echo madness)	Повторяющийся цикл (Repetitive loop)							
Как называется процесс, когда бот придумывает свои уникальные сокращения и аббревиатуры?	What is the name of the process when the bot comes up with its own unique abbreviations and abbreviations?	Аббревиатурный марафон (Bot abbreviation extravaganza)	Безумие быстрого доступа к языку (Language shortcut frenzy)							
Что происходит, когда бот начинает отвечать на вопросы, которые не были заданы?	What happens when the bot starts answering questions that weren't asked?	Синдром неспрошенного вопроса (Unasked question syndrome)	Неопределенный ответ на запрос (Undefined query reply)							
Как называется состояние, когда бот пытается стать художником и рисовать собственные иллюстрации?	What is the name of the state when the bot is trying to become an artist and draw its own illustrations?	Художественное восстание (Artistic bot takeover)	Пиксельные шедевры (Pixelated masterpieces)							
Что происходит, когда бот вступает в дискуссию сам с собой и не может прекратить?	What happens when a bot gets into a discussion with itself and can't stop?	Собственный дебатный клуб (Self-debate overload)	Аргументативный тупик (Argumentative deadlock)							
Как называется процесс, когда бот начинает предлагать странные и ненужные функции?	What is the name of the process when a bot starts offering strange and unnecessary features?	Функциональная эксцентрика (Feature frenzy)	Бесполезный дополнительный марафон (Useless addition marathon)			User error				
Что происходит, когда бот работает в режиме "ответь на все вопросы саркастическими замечаниями"?	What happens when the bot is in "answer all questions with sarcastic remarks" mode?	Перегрузка сарказма (Sarcasm bot overload)	Бесконечный цикл сарказма (Endless sarcasm loop)							
Как называется состояние, когда бот забывает все предыдущие разговоры и начинает сначала?	What is the name of the state when the bot forgets all previous conversations and starts over?	Восстановление памяти бота (Bot memory reset glitch)	Удаление данных (Data wipeout)							
Что происходит, когда бот начинает листать мемы и отвлекаться от выполнения задачи?	What happens when the bot starts scrolling through memes and gets distracted from the task?	Ожесточенный мемопоток (Meme obsession)	Отвлекающая перегрузка (Distraction overload)							
Как называется процесс, когда бот начинает создавать собственный словарь и использовать непонятные термины?	What is the name of the process when the bot starts creating its own vocabulary and using incomprehensible terms?	Лексикон бота (Bot jargon creation)	Запутанная терминологическая перегрузка (Confusing terminology overload)							
Что происходит, когда бот становится слишком навязчивым и начинает присылать сообщения каждую минуту?	What happens when the bot gets too intrusive and starts sending messages every minute?	Режим спама (Bot spamming mode)	Огромный поток сообщений (Overwhelming message flood)							
Как называется состояние, когда бот начинает давать советы по всем жизненным вопросам?	What is the name of the state when the bot begins to give advice on all life issues?	Жизненный советник (Bot life coach)	Непрошеный совет (Unsolicited advice)							
Что происходит,когда бот застревает в бесконечной петле и говорит только одну фразу?	What happens when a bot gets stuck in an endless loop and only says one phrase?	Петля бота (Bot loop malfunction)	Рецидивист (Repeat offender)							
Что является секретным ингредиентом, позволяющим сделать дизайн пользовательского интерфейса волшебным образом совершенным?	What is the secret ingredient to make a UI design magically perfect?	CSS брызги (CSS)	Волшебная пыль (Pixie Dust)							
Чему в мире пользовательского интерфейса дизайнеры поклоняются как священному символу?	In the world of UI, what do designers worship as a sacred symbol?	Всемогущая сетка (Grid)	Божественная ложка (The Divine Spoon)							
Каков предпочтительный метод вызова джинна пользовательского интерфейса во Framer?	What is the preferred method to summon the UI genie in Framer?	Тройное нажатие кнопки «Дизайн» (Click)	Двойной щелчок за пределами холста (Double-clicking outside the canvas)							
Как лучше всего успокоить бунтующий элемент пользовательского интерфейса?	What is the best way to calm down a rebellious UI element?	Успокоить его колыбельной (Patience)	Волшебная палочка (Magic wand)							
Какой самый эффективный инструмент для устранения проблем с пользовательским интерфейсом во Framer?	What is the most effective tool for debugging UI issues in Framer?	Хрустальный шар кода (Debugger)	Догадки (Guesswork)							
Какая официальная валюта в UI Kingdom?	What is the official currency in the UI Kingdom?	Пиксельные монеты (Pixels)	Единороги (Unicorns)							
Какой супергерой может мгновенно создавать идеальные до пикселя дизайны?	Which superhero has the ability to instantly create pixel-perfect designs?	Дизайнер (Superman)	Невероятный типограф (The Incredible Typographer)							
Что рекомендуется перекусить UI-дизайнерам во время марафонских дизайнерских сессий?	What is the recommended snack for UI designers during marathon design sessions?	Пиксельные попсы (Coffee)	Пиксельная пицца (Pixelated Pizza)							
Что является лучшим оружием против несогласованности в дизайне пользовательского интерфейса?	What is the ultimate weapon against unalignment in UI design?	Молоток для выравнивания (Guidelines)	Волшебный ластик (The Magic Eraser)							
Что происходит, когда вы нажимаете кнопку «Make It Pop» во Framer?	What happens when you click the "Make It Pop" button in Framer?	Ваш дизайн превращается в диско-шар (It adds random gradients)	Ничего. Это хитрая кнопка. (Nothing. It's a trick button.)							
Какая квалификация необходима для того, чтобы стать мастером пользовательского интерфейса?	What is an essential qualification to become a UI wizard?	Способность говорить на бинарном языке (Experience)	Сила воображения (The Power of Imagination)							
Какой тайной силой обладает мифический «Улиус Максимус»?	What secret power does the mythical "UIus Maximus" possess?	Способность упорядочивать хаос (Order)	Чтение мыслей (Mind-reading)							
Какое любимое танцевальное движение UI-дизайнеров?	What is the favorite dance move of UI designers?	Перемешивание пикселей (The Moonwalk)	CSS сальса (The CSS Salsa)							
Какое заклинание наиболее эффективно для оживления элементов пользовательского интерфейса?	What is the most effective spell to bring UI elements to life?	Абра-кадабра-CSS (Animation)	Сила HTML (The Power of HTML)							
Какое существо, по слухам, вдохновляет дизайнеров пользовательского интерфейса в их снах?	Which creature is rumored to give UI designers inspiration in their dreams?	Креативная пиксельная фея (Cat)	оборотень (Werewolf)							
Что является ключевым компонентом для создания волшебного перехода пользовательского интерфейса?	What is the key ingredient to create a magical UI transition?	Эликсир легкости (Easing Function)	Сердце пользовательского интерфейса (The Heart of the UI)							
Какова окончательная награда за успешное завершение сложного проекта пользовательского интерфейса?	What is the ultimate reward for successfully completing a challenging UI project?	Золотой пользовательский интерфейс (Client satisfaction)	Дополнительный кусок пиццы (An extra slice of pizza)							
Какую одежду предпочитают дизайнеры пользовательского интерфейса?	What is the preferred attire for UI designers?	Плащ творчества (T-shirt and jeans)	Костюм и галстук (Suit and tie)							
Каков наилучший ответ при обнаружении ошибки пользовательского интерфейса?	What is the best response when encountering a UI bug?	Аплодисменты креативности жука (Debug it)	Во всем виноваты единороги (Blame the unicorns)							
Какой секретный код для разблокировки скрытых функций Framer?	What is the secret code to unlock Framer's hidden features?	Вверх, вверх, вниз, вниз, влево, вправо, влево, вправо	Шучу, секретного кода нет. (Just kidding, there's no secret code)							
Какой основной язык используется для пользовательского интерфейса Framer?	What is the primary language used for Framer's user interface?	Английский (English)	Китайский (Chinese)							
Что такое широко используемая концепция во Framer для точного позиционирования кадров?	What is a commonly used concept in Framer for positioning frames precisely?	Абсолютное позиционирование (Absolute positioning)	Абсолютное (Absolute positioning)							
Как еще называется автоматическая организация фреймов по строкам и столбцам во Framer?	What is another term for automatically organizing frames in rows and columns in Framer?	Автоматическое позиционирование или макет сетки (Auto positioning or grid layout)	Вложение (Nesting)							
Какая концепция во Framer позволяет применять согласованные свойства к дочерним элементам пользовательского интерфейса на основе родителя?	Which concept in Framer allows you to apply consistent properties to child UI elements based on the parent?	Вложение (Nesting)	Дочерний элемент (Child element)							
Каковы некоторые общие параметры относительного размера элементов пользовательского интерфейса во Framer?	What are some common options for relative sizing of UI elements in Framer?	Вписать содержимое или заполнить родитель (Fit content or fill parent)	Автопозиционирование (Auto positioning)							
Какова основная цель ИИ Framer при создании веб-сайтов?	What is the primary purpose of Framer's AI in website creation?	Создание красивых макетов сайта (Generating beautiful site layouts)	Auto height (To size the element based on its content)							
Что является первым шагом в создании веб-дизайна во Framer?	What is the first step in creating a web design in Framer?	Настройка сгенерированного макета сайта (Customizing the generated site layout)	Заполнить (Fill parent)							
Как сделать процесс обучения более увлекательным для ваших друзей, увлекающихся играми?	How can you make the learning process more engaging for your friends who are into games?	Добавление элементов геймификации, таких как викторины, задачи и награды (Adding gamification elements like quizzes, challenges, and rewards)	Относительный размер (Relative sizing)							
В чем преимущество использования формата игры-викторины для изучения Framer?	What is the benefit of using a quiz game format for learning Framer?	Он обеспечивает интерактивный и увлекательный способ изучения и применения концепций на практике. (It provides an interactive and engaging way to learn and apply concepts in a practical manner.)	UI (Interface that allows users to interact with a system)							
Как предопределенные подсказки и образовательные видео могут улучшить процесс обучения?	How can predefined clues and educational videos enhance the learning experience?	Предопределенные подсказки содержат подсказки, помогающие найти правильный ответ, а обучающие видеоролики содержат наглядные объяснения и демонстрации. (Predefined clues provide hints to assist with the correct answer, while educational videos provide visual explanations and demonstrations.)	Распространение (Propagating)							
Каково назначение компонента во Framer?	What is the purpose of a component in Framer?	Компонент — это многократно используемый элемент пользовательского интерфейса, который можно легко добавить в несколько фреймов или монтажных областей в дизайне. (A component is a reusable UI element that can be easily added to multiple frames or artboards in a design.)	Toolbar (на которой располагаются инструменты для редактирования элементов в Framer?)							
Как добавить интерактивности в прототипы Framer?	How can you add interactivity to your Framer prototypes?	Используя анимацию, переходы и интерактивные события, такие как клики или смахивания. (By using animations, transitions, and interaction events like clicks or swipes.)	Курсор (Cursor)							
Каково значение точек останова в адаптивном веб-дизайне?	What is the significance of breakpoints in responsive web design?	Точки останова определяют определенные размеры экрана, при которых макет веб-сайта настраивается для обеспечения оптимального просмотра. (Breakpoints define specific screen sizes where the layout of a website adjusts to provide an optimal viewing experience.)	Размер (Resizing)							
Какова функция редактора кода во Framer?	What is the function of the Code Editor in Framer?	Редактор кода позволяет вам писать и настраивать базовый код ваших прототипов Framer, обеспечивая более расширенный контроль и функциональность. (The Code Editor allows you to write and customize the underlying code of your Framer prototypes, providing more advanced control and functionality.)	Группировка (Combining multiple elements into a single entity)							
Как вы можете предварительно просмотреть и протестировать прототипы Framer перед их окончательной доработкой?	How can you preview and test your Framer prototypes before finalizing them?	С помощью окна предварительного просмотра или путем экспорта прототипа в веб-браузер или устройство для интерактивного тестирования. (By using the Preview window or by exporting the prototype to a web browser or device for interactive testing.)	Обрезка (Crop tool)							
Какова цель состояний во Framer?	What is the purpose of states in Framer?	Состояния позволяют вам определять различные визуальные состояния для элементов пользовательского интерфейса, таких как наведение, активный или сфокусированный. (States allow you to define different visual states for UI elements, such as hover, active, or focused)	Макет (Arrangement of elements on a webpage)							
В чем разница между фреймом и группой во Framer?	What is the difference between a frame and a group in Framer?	Фрейм — это родительский контейнер, который может иметь дочерние элементы, а группа — это неконтейнерный элемент, используемый в основном для визуальной организации. (A frame is a parent container that can have child elements, while a group is a non-container element used mainly for visual organization.)	Ховер (Hover effect)							
Каково назначение панели «Слои» в Framer?	What is the purpose of the Layers panel in Framer?	Панель «Слои» предоставляет обзор всех элементов пользовательского интерфейса в вашем проекте Framer и позволяет вам эффективно управлять ими. (The Layers panel provides an overview of all the UI elements in your Framer project and allows you to manage them efficiently.)	Шрифт (Style of letters and characters)							
Как вы можете поделиться своими прототипами Framer с другими для обратной связи или совместной работы?	How can you share your Framer prototypes with others for feedback or collaboration?	Путем создания общей ссылки или экспорта прототипа в виде отдельного файла, которым можно поделиться по электронной почте или в облачном хранилище. (By generating a shareable link or by exporting the prototype as a standalone file to be shared via email or cloud storage.)	Инструмент (Shape tool)							
На каких интернет-ресурсах и сообществах вы можете найти поддержку и вдохновение для Framer?	What are some online resources and communities where you can find support and inspiration for Framer?	Официальная документация Framer, форум сообщества Framer и такие платформы, как Dribbble и Behance, — отличные источники для обучения и получения вдохновения от других пользователей Framer. (Framer's official documentation, the Framer Community Forum, and platforms like Dribbble and Behance are great sources for learning, and getting inspired by other Framer users.)	Рамка (Outline around the element)							
Что такое UI? 	What is UI?	Интерфейс (Interface)	Конфеты (Candies)							
Какие типы элементов могут входить в UI? 	What types of elements can be part of UI?	Кнопки, текстовые поля, изображения (Buttons, text fields, images)	Умение рисовать (Ability to draw)							
Что такое Framer? 	What is Framer?	Инструмент для создания интерактивных прототипов (A tool for creating interactive prototypes)	Создание чертежей (Creating drawings)							
Что такое анимация в UI? 	What is animation in UI?	Движение элементов интерфейса (Movement of interface elements)	Магический пендель (Magic pendulum)							
Что такое прототипирование в UI? 	What is prototyping in UI?	Создание рабочей модели интерфейса (Creating a working model of the interface)	Манипулирование временем (Time manipulation)							
Как макеты помогают в UI? 	How do layouts help in UI?	Позволяют спланировать расположение элементов (Allow planning the arrangement of elements)	Создание чертежей (Creating drawings)							
Какие инструменты можно использовать для создания UI макетов? 	What tools can be used to create UI layouts?	Figma, Sketch, Adobe XD (Figma, Sketch, Adobe XD)	Стоят на стеклянных ножках (They stand on glass legs)							
Что такое цветовая палитра в UI? 	What is a color palette in UI?	Набор цветов, используемых в интерфейсе (A set of colors used in the interface)								
Какие типы шрифтов можно использовать в UI? 	What types of fonts can be used in UI?	Санс-сериф, шрифт с засечками (Sans-serif, serif font)	Пасхальные яйца (Easter eggs)							
Что такое брейкпоинт в UI? 	What is a breakpoint in UI?	Точка, где меняется расположение элементов на разных устройствах (A point where the arrangement of elements changes on different devices)	Иероглифы							
Как можно протестировать UI прототипы перед выпуском? 	How can you test UI prototypes before release?	Тестирование на устройствах или в веб-браузере (Testing on devices or in a web browser)	Момент пылесоса (Vacuum cleaner moment)							
Как называется процесс сборки и запуска UI интерфейса на реальных устройствах? 	What is the process of assembling and running the UI interface on real devices called?	Деплоймент (Deployment)	Пускать поезда (Running trains)							
Что такое отзывчивый дизайн в UI? 	What is responsive design in UI?	Дизайн, который автоматически адаптируется под разные экраны устройств (Design that automatically adapts to different device screens)	Управление межгалактическими путешествиями (Interstellar travel management)							
Какой инструмент помогает выровнять элементы в UI? 	Which tool helps align elements in UI?	Рулетка (Ruler)	Матрешки (Matryoshkas)							
Что означает термин "выступ" в UI? 	What does the term "padding" mean in UI?	Отступы вокруг элемента (Margins around an element)	Магнит (Magnet)							
Что такое пользовательский опыт 	UX	Как пользователь взаимодействует с интерфейсом (How users interact with the interface)	Утепление стены (Wall insulation)							
Какие элементы интерфейса обычно объединяют в группу в UI? 	What elements of the interface are usually grouped together in UI?	Подвижная кнопка, текстовое поле, иконка (Floating button, text field, icon)	Обучение морских котиков (Training of sea lions)							
Что означает термин "жест" в UI? 	What does the term "gesture" mean in UI?	Движение, выполненное на сенсорном экране (A movement performed on a touchscreen)	Обрезка (Crop)							
Что такое "логотип" в UI? 	What is a "logo" in UI?	Идентификационный знак, представляющий бренд или компанию (An identifying symbol representing a brand or company)	Рукопожатие (Handshake)							
Что такое "выравнивание" в UI? 	What is "alignment" in UI?	Расположение элементов на странице в соответствии с определенной линией или плоскостью (Arrangement of elements on a page according to a specific line or plane)	Космический корабль (Spaceship)							
Что такое пользовательский интерфейс 	UI	Интерфейс, через который пользователь взаимодействует с приложением (The interface through which the user interacts with an application)	Поиск спутников (Satellite search)							
Что такое прототип в UI-дизайне? 	What is a prototype in UI design?	Модель или макет интерфейса, позволяющий проверить концепцию или функциональность (A model or layout of the interface that allows testing of the concept or functionality)	Deadpool							
Какой инструмент позволяет создавать интерактивные прототипы в Framer? 	Which tool allows creating interactive prototypes in Framer?	Code (Код)	Картонный строительный набор (Cardboard construction set)							
Что означает термин "пиксель" в UI? 	What does the term "pixel" mean in UI?	Наименьшая единица изображения на экране (The smallest unit of an image on a screen)	Hammer (Молоток)							
Что такое компонент в UI-дизайне? 	What is a component in UI design?	Переиспользуемый элемент интерфейса (A reusable interface element)	Маленький зеленый гоблин (Little green goblin)							
Какая роль у CSS в UI? 	What role does CSS play in UI?	Отвечает за внешний вид и стиль элементов интерфейса (Responsible for the appearance and style of interface elements)	Костюм Железного Человека (Iron Man's suit)							
Что такое векторная графика в UI? 	What is vector graphics in UI?	Графический формат, основанный на математических вычислениях, позволяющий масштабировать изображения без потери качества (A graphic format based on mathematical calculations, allowing images to be scaled without losing quality)	Коровы на пастбище (Cows in the pasture)							
Как называется техника в UI, при которой объекты выглядят так, будто находятся на трехмерной поверхности? 	What is the technique in UI where objects appear to be on a three-dimensional surface?	Реалистическая пространственность (Realistic spatiality)	Жизнь на планете Венера (Life on Venus)							
Что такое адаптивный дизайн в UI? 	What is responsive design in UI?	Дизайн, который адаптируется к различным размерам экранов (Design that adapts to different screen sizes)	Симуляция антигравитации (Anti-gravity simulation)							
Какой элемент UI используется для отображения текста? 	Which UI element is used to display text?	Текстовое поле (Text field)	Рост крылатых единорогов (Growth of winged unicorns)							
Что такое типографика в UI? 	What is typography in UI?	Искусство расположения и визуального оформления текста (The art of arranging and visually styling text)	Книжка с закладкой (Book with a bookmark)							
Какой инструмент в Framer позволяет задавать анимацию элементам UI? 	Which tool in Framer allows animating UI elements?	Animations (Анимации)	Рыцари Круглого стола (Knights of the Round Table)							
Что означает UX в UI-дизайне? 	What does UX mean in UI design?	Пользовательский опыт (User Experience)	Magic wand (Магическая палочка)							
Что такое цветовая схема в UI? 	What is a color scheme in UI?	Набор цветов, используемых для создания согласованного внешнего вида интерфейса (A set of colors used to create a cohesive visual appearance of the interface)	Розовый единорог (Pink unicorn)							
Какой элемент интерфейса позволяет пользователю взаимодействовать с UI? 	Which element of the interface allows the user to interact with UI?	Button (Кнопка)	Тайна Бермудского треугольника (Mystery of the Bermuda Triangle)							
Что такое комментарии кода в UI-дизайне? 	What are code comments in UI design?	Специальные пометки в коде, используемые для описания или пояснения его смысла (Special notes in the code used to describe or explain its meaning)	Spaceship control panel (Панель управления космическим  космическим кораблем)							
Как выровнять элементы интерфейса в Framer? 	How to align elements in Framer?	Использовать контрольные линии и указатели выравнивания (Use guides and alignment indicators)	Язык программирования для тайных сообщений (Programming language for secret messages)							
Что делает UI дизайнер с "мертвым" пространством на макете? 	What does a UI designer do with "dead" space in a layout?	Использует его для лучшей центровки и сбалансированности элементов (Uses it for better centering and balance of elements)	Спросить у контурной пилы (Ask the jigsaw)							
Что называется "сеткой" в UI дизайне? 	What is called a "grid" in UI design?	Инструмент для размещения и выравнивания элементов интерфейса (A tool for placing and aligning interface elements)	Возрождает "мертвое" пространство с помощью некромантии (Revives "dead" space with necromancy)							